 Button (master, options)
 - activebackground: цвет кнопки, когда она находится в нажатом состоянии

 - activeforeground: цвет текста кнопки, когда она в нажатом состоянии

 - bd: толщина границы (по умолчанию 2)

 - bg/background: фоновый цвет кнопки

 - fg/foreground: цвет текста кнопки

 - font: шрифт текста, например, font="Arial 14" - шрифт Arial высотой 14px, или font=("Verdana", 13, "bold") - шрифт Verdana высотой 13px с выделением жирным

 - height: высота кнопки

 - highlightcolor: цвет кнопки, когда она в фокусе

 - image: изображение на кнопке

 - justify: устанавливает выравнивание текста. Значение LEFT выравнивает текст по левому краю, CENTER - по центру, RIGHT - по правому краю

 - padx: отступ от границ кнопки до ее текста справа и слева

 - pady: отступ от границ кнопки до ее текста сверху и снизу

 - relief: определяет тип границы, может принимать значения SUNKEN, RAISED, GROOVE, RIDGE

 - state: устанавливает состояние кнопки, может принимать значения DISABLED, ACTIVE, NORMAL (по умолчанию)

 - text: устанавливает текст кнопки

 - textvariable: устанавливает привязку к элементу StringVar

 - underline: указывает на номер символа в тексте кнопки, который подчеркивается. По умолчанию значение -1, то есть никакой символ не подчеркивается

 - width: ширина кнопки

 - wraplength: при положительном значении строки текста будут переносится для вмещения в пространство кнопки


 pack()

 - expand: если равно True, то виджет заполняет все пространство контейнера.

 - fill: определяет, будет ли виджет растягиваться, чтобы заполнить свободное пространство вокруг. Этот параметр может принимать следующие значения: NONE (по умолчанию, элемент не растягивается), X (элемент растягивается только по горизонтали), Y (элемент растягивается только по вертикали) и BOTH (элемент растягивается по вертикали и горизонтали).

 - side: выравнивает виджет по одной из сторон контейнера. Может принимать значения: TOP (по умолчанию, выравнивается по верхней стороне контейнера), BOTTOM (выравнивание по нижней стороне), LEFT (выравнивание по левой стороне), RIGHT (выравнивание по правой стороне
 

 Метод place() позволяет более точно настроить параметры позиционирования. Он принимает следующие параметры:

 - height и width: устанавливают соответственно высоту и ширину элемента в пикселях

 - relheight и relwidth: также задают соответственно высоту и ширину элемента, но в качестве значения используется число float в промежутке между 0.0 и 1.0, которое указывает на долю от высоты и ширины родительского контейнера

 - x и y: устанавливают смещение элемента по горизонтали и вертикали в пикселях соответственно относительно верхнего левого угла контейнера

 - relx и rely: также задают смещение элемента по горизонтали и вертикали, но в качестве значения используется число float в промежутке между 0.0 и 1.0, которое указывает на долю от высоты и ширины родительского контейнера

 - bordermode: задает формат границы элемента. Может принимать значение INSIDE (по умолчанию) и OUTSIDE

 - anchor: устанавливает опции растяжения элемента. Может принимать значения n, e, s, w, ne, nw, se, sw, c, которые являются сокращениями от Noth(север - вверх), South (юг - низ), East (восток - правая сторона), West (запад - левая сторона) и Center (по центру). Например, значение nw указывает на верхний левый угол


 Метод grid применяет следующие параметры:

 - column: номер столбца, отсчет начинается с нуля
 
 - row: номер строки, отсчет начинается с нуля

 - columnspan: сколько столбцов должен занимать элемент

 - rowspan: сколько строк должен занимать элемент

 - ipadx и ipady: отступы по горизонтали и вертикали соответственно от границ элемента до его текста

 - padx и pady: отступы по горизонтали и вертикали соответственно от границ ячейки грида до границ элемента

 - sticky: выравнивание элемента в ячейке, если ячейка больше элемента. Может принимать значения n, e, s, w, ne, nw, se, sw, которые указывают соответствующее направление выравнивания

